###################################################################################################
#                                                ##                                               #
#                                               ####                                              #
#                                              ######                                             #
#                                             ########                                            #
#                                            ##########                                           #
#                                           ############                                          #
#                                          ##############                                         #
#                                         ################                                        #
#                                        ##################                                       #
#                                       ####################                                      #
#                                      ######################                                     #
#                                     ########################                                    #
#                                    ##########################                                   #
#                                   ############################                                  #
#                                  ##############################                                 #
#                                 ################################                                #
#                                ##################################                               #
#                               ####################################                              #
#                              ######################################                             #
#                             ########################################                            #
#                            ##########################################                           #
#                           ############################################                          #
#                          ##############################################                         #
#                         ################################################                        #
#                        ##################################################                       #
#                       ####################################################                      #
#                      ######################################################                     #
#                     ########################################################                    #
#                    ##########################################################                   #
#                   ############################################################                  #
#                  ##############################################################                 #
#                 ################################################################                #
#                ##################################################################               #
#               ####################################################################              #
#              ######################################################################             #
#             ########################################################################            #
#            ##########################################################################           #
#           ############################################################################          #
#          ##############################################################################         #
#         ################################################################################        #
#        ##################################################################################       #
#       ####################################################################################      #
#      ######################################################################################     #
#     ########################################################################################    #
#    ##########################################################################################   #
#   ############################################################################################  #
#  ############################################################################################## #
###################################################################################################